primer_name	sequence_nnn
RBD-for-mut1	 tcgtgcgatttccaNNNATTACCAACCTCTG
RBD-for-mut2	 gcgatttccaAACNNNACCAACCTCTGCC
RBD-for-mut3	 cgatttccaAACATTNNNAACCTCTGCCCCTTC
RBD-for-mut4	 tccaAACATTACCNNNCTCTGCCCCTTCG
RBD-for-mut5	 AACATTACCAACNNNTGCCCCTTCGGC
RBD-for-mut6	 ATTACCAACCTCNNNCCCTTCGGCGAG
RBD-for-mut7	 CCAACCTCTGCNNNTTCGGCGAGGT
RBD-for-mut8	 ACCTCTGCCCCNNNGGCGAGGTGTT
RBD-for-mut9	 CTCTGCCCCTTCNNNGAGGTGTTTAACG
RBD-for-mut10	 GCCCCTTCGGCNNNGTGTTTAACGC
RBD-for-mut11	 CCTTCGGCGAGNNNTTTAACGCCACA
RBD-for-mut12	 TCGGCGAGGTGNNNAACGCCACAAG
RBD-for-mut13	 GGCGAGGTGTTTNNNGCCACAAGATTTG
RBD-for-mut14	 GCGAGGTGTTTAACNNNACAAGATTTGCCTCC
RBD-for-mut15	 GGTGTTTAACGCCNNNAGATTTGCCTCCG
RBD-for-mut16	 TGTTTAACGCCACANNNTTTGCCTCCGTTTAC
RBD-for-mut17	 AACGCCACAAGANNNGCCTCCGTTTAC
RBD-for-mut18	 CGCCACAAGATTTNNNTCCGTTTACGCCT
RBD-for-mut19	 CACAAGATTTGCCNNNGTTTACGCCTGGAA
RBD-for-mut20	 CAAGATTTGCCTCCNNNTACGCCTGGAATAGA
RBD-for-mut21	 AGATTTGCCTCCGTTNNNGCCTGGAATAGAAAG
RBD-for-mut22	 GATTTGCCTCCGTTTACNNNTGGAATAGAAAGAGAAT
RBD-for-mut23	 GCCTCCGTTTACGCCNNNAATAGAAAGAGAATCA
RBD-for-mut24	 CCGTTTACGCCTGGNNNAGAAAGAGAATCAG
RBD-for-mut25	 CGTTTACGCCTGGAATNNNAAGAGAATCAGCAATTG
RBD-for-mut26	 TTTACGCCTGGAATAGANNNAGAATCAGCAATTGTGT
RBD-for-mut27	 GCCTGGAATAGAAAGNNNATCAGCAATTGTGTGG
RBD-for-mut28	 TGGAATAGAAAGAGANNNAGCAATTGTGTGGCC
RBD-for-mut29	 GGAATAGAAAGAGAATCNNNAATTGTGTGGCCGACTA
RBD-for-mut30	 GAAAGAGAATCAGCNNNTGTGTGGCCGACTA
RBD-for-mut31	 AGAGAATCAGCAATNNNGTGGCCGACTACTC
RBD-for-mut32	 AATCAGCAATTGTNNNGCCGACTACTCCGT
RBD-for-mut33	 CAGCAATTGTGTGNNNGACTACTCCGTGC
RBD-for-mut34	 CAATTGTGTGGCCNNNTACTCCGTGCTGTA
RBD-for-mut35	 GTGTGGCCGACNNNTCCGTGCTGTA
RBD-for-mut36	 TGTGGCCGACTACNNNGTGCTGTATAACAG
RBD-for-mut37	 GGCCGACTACTCCNNNCTGTATAACAGCG
RBD-for-mut38	 CGACTACTCCGTGNNNTATAACAGCGCCTC
RBD-for-mut39	 ACTCCGTGCTGNNNAACAGCGCCTC
RBD-for-mut40	 CTCCGTGCTGTATNNNAGCGCCTCTTTCA
RBD-for-mut41	 CGTGCTGTATAACNNNGCCTCTTTCAGCAC
RBD-for-mut42	 GTGCTGTATAACAGCNNNTCTTTCAGCACCTTCA
RBD-for-mut43	 TGTATAACAGCGCCNNNTTCAGCACCTTCAA
RBD-for-mut44	 ATAACAGCGCCTCTNNNAGCACCTTCAAGTG
RBD-for-mut45	 AGCGCCTCTTTCNNNACCTTCAAGTGCT
RBD-for-mut46	 CGCCTCTTTCAGCNNNTTCAAGTGCTACG
RBD-for-mut47	 TCTTTCAGCACCNNNAAGTGCTACGGC
RBD-for-mut48	 TTCAGCACCTTCNNNTGCTACGGCGTT
RBD-for-mut49	 AGCACCTTCAAGNNNTACGGCGTTTCC
RBD-for-mut50	 CCTTCAAGTGCNNNGGCGTTTCCCC
RBD-for-mut51	 CCTTCAAGTGCTACNNNGTTTCCCCAACAAAG
RBD-for-mut52	 AAGTGCTACGGCNNNTCCCCAACAAAG
RBD-for-mut53	 TGCTACGGCGTTNNNCCAACAAAGCTG
RBD-for-mut54	 CTACGGCGTTTCCNNNACAAAGCTGAATGA
RBD-for-mut55	 GGCGTTTCCCCANNNAAGCTGAATGACC
RBD-for-mut56	 CGTTTCCCCAACANNNCTGAATGACCTGTG
RBD-for-mut57	 GTTTCCCCAACAAAGNNNAATGACCTGTGCTTC
RBD-for-mut58	 CCAACAAAGCTGNNNGACCTGTGCTTCA
RBD-for-mut59	 CCAACAAAGCTGAATNNNCTGTGCTTCACCAAC
RBD-for-mut60	 CAAAGCTGAATGACNNNTGCTTCACCAACGT
RBD-for-mut61	 AGCTGAATGACCTGNNNTTCACCAACGTGTAC
RBD-for-mut62	 GAATGACCTGTGCNNNACCAACGTGTACG
RBD-for-mut63	 GACCTGTGCTTCNNNAACGTGTACGCC
RBD-for-mut64	 TGTGCTTCACCNNNGTGTACGCCGA
RBD-for-mut65	 TGCTTCACCAACNNNTACGCCGACTCC
RBD-for-mut66	 TCACCAACGTGNNNGCCGACTCCTTC
RBD-for-mut67	 CTTCACCAACGTGTACNNNGACTCCTTCGTAATTAG
RBD-for-mut68	 CCAACGTGTACGCCNNNTCCTTCGTAATTAGA
RBD-for-mut69	 ACGTGTACGCCGACNNNTTCGTAATTAGAGG
RBD-for-mut70	 GTACGCCGACTCCNNNGTAATTAGAGGCG
RBD-for-mut71	 GCCGACTCCTTCNNNATTAGAGGCGATG
RBD-for-mut72	 CGACTCCTTCGTANNNAGAGGCGATGAGG
RBD-for-mut73	 CTCCTTCGTAATTNNNGGCGATGAGGTGC
RBD-for-mut74	 CCTTCGTAATTAGANNNGATGAGGTGCGGCAG
RBD-for-mut75	 GTAATTAGAGGCNNNGAGGTGCGGCAGA
RBD-for-mut76	 ATTAGAGGCGATNNNGTGCGGCAGATC
RBD-for-mut77	 GAGGCGATGAGNNNCGGCAGATCGC
RBD-for-mut78	 GCGATGAGGTGNNNCAGATCGCACC
RBD-for-mut79	 ATGAGGTGCGGNNNATCGCACCAGG
RBD-for-mut80	 AGGTGCGGCAGNNNGCACCAGGCCA
RBD-for-mut81	 TGCGGCAGATCNNNCCAGGCCAGAC
RBD-for-mut82	 GGCAGATCGCANNNGGCCAGACCGG
RBD-for-mut83	 CAGATCGCACCANNNCAGACCGGTAAGA
RBD-for-mut84	 ATCGCACCAGGCNNNACCGGTAAGATC
RBD-for-mut85	 CACCAGGCCAGNNNGGTAAGATCGCT
RBD-for-mut86	 CAGGCCAGACCNNNAAGATCGCTGAC
RBD-for-mut87	 GGCCAGACCGGTNNNATCGCTGACTAC
RBD-for-mut88	 CCAGACCGGTAAGNNNGCTGACTACAACTA
RBD-for-mut89	 CCAGACCGGTAAGATCNNNGACTACAACTATAAGCT
RBD-for-mut90	 GACCGGTAAGATCGCTNNNTACAACTATAAGCTGC
RBD-for-mut91	 GGTAAGATCGCTGACNNNAACTATAAGCTGCCTG
RBD-for-mut92	 GTAAGATCGCTGACTACNNNTATAAGCTGCCTGATGA
RBD-for-mut93	 CGCTGACTACAACNNNAAGCTGCCTGATG
RBD-for-mut94	 TCGCTGACTACAACTATNNNCTGCCTGATGATTTTAC
RBD-for-mut95	 CTGACTACAACTATAAGNNNCCTGATGATTTTACAGGC
RBD-for-mut96	 ACTACAACTATAAGCTGNNNGATGATTTTACAGGCTGC
RBD-for-mut97	 AACTATAAGCTGCCTNNNGATTTTACAGGCTGC
RBD-for-mut98	 ATAAGCTGCCTGATNNNTTTACAGGCTGCGT
RBD-for-mut99	 CTGCCTGATGATNNNACAGGCTGCGTGA
RBD-for-mut100	 CCTGATGATTTTNNNGGCTGCGTGATCG
RBD-for-mut101	 CTGATGATTTTACANNNTGCGTGATCGCCTGG
RBD-for-mut102	 ATGATTTTACAGGCNNNGTGATCGCCTGGAA
RBD-for-mut103	 TTTTACAGGCTGCNNNATCGCCTGGAACT
RBD-for-mut104	 CAGGCTGCGTGNNNGCCTGGAACTC
RBD-for-mut105	 CAGGCTGCGTGATCNNNTGGAACTCTAACAA
RBD-for-mut106	 CTGCGTGATCGCCNNNAACTCTAACAACC
RBD-for-mut107	 GTGATCGCCTGGNNNTCTAACAACCTGG
RBD-for-mut108	 TGATCGCCTGGAACNNNAACAACCTGGATAG
RBD-for-mut109	 TCGCCTGGAACTCTNNNAACCTGGATAGCAA
RBD-for-mut110	 CCTGGAACTCTAACNNNCTGGATAGCAAGGTG
RBD-for-mut111	 GGAACTCTAACAACNNNGATAGCAAGGTGGG
RBD-for-mut112	 TCTAACAACCTGNNNAGCAAGGTGGGCG
RBD-for-mut113	 ACAACCTGGATNNNAAGGTGGGCGG
RBD-for-mut114	 ACCTGGATAGCNNNGTGGGCGGCAA
RBD-for-mut115	 CTGGATAGCAAGNNNGGCGGCAACTACA
RBD-for-mut116	 CTGGATAGCAAGGTGNNNGGCAACTACAACTAC
RBD-for-mut117	 GATAGCAAGGTGGGCNNNAACTACAACTACCTG
RBD-for-mut118	 AAGGTGGGCGGCNNNTACAACTACCTG
RBD-for-mut119	 GTGGGCGGCAACNNNAACTACCTGTAC
RBD-for-mut120	 GGCGGCAACTACNNNTACCTGTACCGG
RBD-for-mut121	 GGCAACTACAACNNNCTGTACCGGCTGT
RBD-for-mut122	 GCAACTACAACTACNNNTACCGGCTGTTTCG
RBD-for-mut123	 TACAACTACCTGNNNCGGCTGTTTCGCA
RBD-for-mut124	 ACTACAACTACCTGTACNNNCTGTTTCGCAAGTCTAA
RBD-for-mut125	 AACTACCTGTACCGGNNNTTTCGCAAGTCTAAC
RBD-for-mut126	 CTGTACCGGCTGNNNCGCAAGTCTAAC
RBD-for-mut127	 CCTGTACCGGCTGTTTNNNAAGTCTAACCTGAAAC
RBD-for-mut128	 CCGGCTGTTTCGCNNNTCTAACCTGAAAC
RBD-for-mut129	 GGCTGTTTCGCAAGNNNAACCTGAAACCTTTC
RBD-for-mut130	 CTGTTTCGCAAGTCTNNNCTGAAACCTTTCGAGA
RBD-for-mut131	 GTTTCGCAAGTCTAACNNNAAACCTTTCGAGAGAGA
RBD-for-mut132	 GCAAGTCTAACCTGNNNCCTTTCGAGAGAGAC
RBD-for-mut133	 GCAAGTCTAACCTGAAANNNTTCGAGAGAGACATCTC
RBD-for-mut134	 GTCTAACCTGAAACCTNNNGAGAGAGACATCTCCAC
RBD-for-mut135	 CTAACCTGAAACCTTTCNNNAGAGACATCTCCACAGA
RBD-for-mut136	 CTGAAACCTTTCGAGNNNGACATCTCCACAGAG
RBD-for-mut137	 TGAAACCTTTCGAGAGANNNATCTCCACAGAGATCTA
RBD-for-mut138	 CCTTTCGAGAGAGACNNNTCCACAGAGATCTACC
RBD-for-mut139	 TTTCGAGAGAGACATCNNNACAGAGATCTACCAGG
RBD-for-mut140	 AGAGAGACATCTCCNNNGAGATCTACCAGGC
RBD-for-mut141	 AGACATCTCCACANNNATCTACCAGGCCG
RBD-for-mut142	 ATCTCCACAGAGNNNTACCAGGCCGGTT
RBD-for-mut143	 CTCCACAGAGATCNNNCAGGCCGGTTCTA
RBD-for-mut144	 CACAGAGATCTACNNNGCCGGTTCTACACC
RBD-for-mut145	 CACAGAGATCTACCAGNNNGGTTCTACACCTTGTAA
RBD-for-mut146	 GAGATCTACCAGGCCNNNTCTACACCTTGTAAC
RBD-for-mut147	 CTACCAGGCCGGTNNNACACCTTGTAACG
RBD-for-mut148	 AGGCCGGTTCTNNNCCTTGTAACGGG
RBD-for-mut149	 GCCGGTTCTACANNNTGTAACGGGGTG
RBD-for-mut150	 CGGTTCTACACCTNNNAACGGGGTGGAAG
RBD-for-mut151	 TCTACACCTTGTNNNGGGGTGGAAGGC
RBD-for-mut152	 TCTACACCTTGTAACNNNGTGGAAGGCTTCAAC
RBD-for-mut153	 ACCTTGTAACGGGNNNGAAGGCTTCAACTG
RBD-for-mut154	 CTTGTAACGGGGTGNNNGGCTTCAACTGTTA
RBD-for-mut155	 TTGTAACGGGGTGGAANNNTTCAACTGTTACTTCC
RBD-for-mut156	 GGGGTGGAAGGCNNNAACTGTTACTTCC
RBD-for-mut157	 GGTGGAAGGCTTCNNNTGTTACTTCCCTCT
RBD-for-mut158	 GGAAGGCTTCAACNNNTACTTCCCTCTGCA
RBD-for-mut159	 AAGGCTTCAACTGTNNNTTCCCTCTGCAAAG
RBD-for-mut160	 GCTTCAACTGTTACNNNCCTCTGCAAAGCTAC
RBD-for-mut161	 TCAACTGTTACTTCNNNCTGCAAAGCTACGG
RBD-for-mut162	 AACTGTTACTTCCCTNNNCAAAGCTACGGCTTC
RBD-for-mut163	 TTACTTCCCTCTGNNNAGCTACGGCTTCCA
RBD-for-mut164	 TTCCCTCTGCAANNNTACGGCTTCCAG
RBD-for-mut165	 CTCTGCAAAGCNNNGGCTTCCAGCC
RBD-for-mut166	 CTCTGCAAAGCTACNNNTTCCAGCCTACCAAT
RBD-for-mut167	 CAAAGCTACGGCNNNCAGCCTACCAATG
RBD-for-mut168	 AAGCTACGGCTTCNNNCCTACCAATGGAG
RBD-for-mut169	 CTACGGCTTCCAGNNNACCAATGGAGTCG
RBD-for-mut170	 GCTTCCAGCCTNNNAATGGAGTCGGC
RBD-for-mut171	 TCCAGCCTACCNNNGGAGTCGGCTA
RBD-for-mut172	 CAGCCTACCAATNNNGTCGGCTACCAG
RBD-for-mut173	 CCTACCAATGGANNNGGCTACCAGCCAT
RBD-for-mut174	 CTACCAATGGAGTCNNNTACCAGCCATACCG
RBD-for-mut175	 ATGGAGTCGGCNNNCAGCCATACCG
RBD-for-mut176	 GAGTCGGCTACNNNCCATACCGGGTG
RBD-for-mut177	 TCGGCTACCAGNNNTACCGGGTGGT
RBD-for-mut178	 GCTACCAGCCANNNCGGGTGGTCGT
RBD-for-mut179	 TACCAGCCATACNNNGTGGTCGTGCTG
RBD-for-mut180	 AGCCATACCGGNNNGTCGTGCTGTC
RBD-for-mut181	 CATACCGGGTGNNNGTGCTGTCCTTC
RBD-for-mut182	 ACCGGGTGGTCNNNCTGTCCTTCGA
RBD-for-mut183	 CGGGTGGTCGTGNNNTCCTTCGAGTTAC
RBD-for-mut184	 GTGGTCGTGCTGNNNTTCGAGTTACTCC
RBD-for-mut185	 GTCGTGCTGTCCNNNGAGTTACTCCAC
RBD-for-mut186	 GTGCTGTCCTTCNNNTTACTCCACGCC
RBD-for-mut187	 TGTCCTTCGAGNNNCTCCACGCCCC
RBD-for-mut188	 CCTTCGAGTTANNNCACGCCCCCGC
RBD-for-mut189	 TCGAGTTACTCNNNGCCCCCGCCAC
RBD-for-mut190	 AGTTACTCCACNNNCCCGCCACCGT
RBD-for-mut191	 TACTCCACGCCNNNGCCACCGTCTG
RBD-for-mut192	 TCCACGCCCCCNNNACCGTCTGCGG
RBD-for-mut193	 ACGCCCCCGCCNNNGTCTGCGGTCC
RBD-for-mut194	 CCCCCGCCACCNNNTGCGGTCCTAA
RBD-for-mut195	 CCGCCACCGTCNNNGGTCCTAAGAA
RBD-for-mut196	 CCACCGTCTGCNNNCCTAAGAAGTCC
RBD-for-mut197	 ACCGTCTGCGGTNNNAAGAAGTCCACC
RBD-for-mut198	 GTCTGCGGTCCTNNNAAGTCCACCaatc
RBD-for-mut199	 CTGCGGTCCTAAGNNNTCCACCaatctgg
RBD-for-mut200	 TGCGGTCCTAAGAAGNNNACCaatctggttaaga
RBD-for-mut201	 CGGTCCTAAGAAGTCCNNNaatctggttaagaacaa
